######################################
#                             @      #
#          @                         #########
#                                    DDt     #
#     XXXX4z           X=z        S180r3g3z  #
########################=#####################
#                       =#############
#                       =#############
#     CCCC              =#############
#    ######    S Xz     =#############5g180r{(mode)(l)sz}(C)5i
#            ###########=#############
####        ##          =           ##
#  ##########       S   =           ##
#              ### #####=   ##########
#=            ## # #####=   ##########
#=#############  # #####=#############
#=#S   LLLLLLLL  # #### =#############
#=        X@z   B#      =#############
#=       #########W     =#############
##################F###################(2a5b5c1a)p3gz(7-y)ez180rz5g5z5g4z90nrz
