{(t)(1b1a)ps(width)10bs0n10nm}(hn)d{(1+y)e(1 s onCollide|player)q}(ii)d

                                                                  N
(t)(&msg.gamename)s(textSize)8as(width)24bs0n16nmz                   N
(t)()s(width)20bs3bn0m(startupText)d          %%%%%%%%%%%%%%%%%%%%%%%%%%%%%%%%
                            %%%%%%%%%%%%%%%%%%%    =                   @     %
                                                   =                         %
                                                   =                         %
                                             N     =                  M     I%M2g(t)(&msg.wrongWayLeft)sz(1 s onCollide|player)qz(t)(&msg.move)s0n1bm(1 p onGround)qz
                                                   =###################################################################(t)(&msg.climb)sz
                                                   =###################################################################
                                                   =###################################################################
%%%%%%%%%%%%%%%%%%%%%%%%%%%%                       =###################################################################
                           %                       =###################################################################
                           %                       =###################################################################
%                          %                       =###################################################################
%                          %                       =###################################################################
%                          %                       =L          N             M    I #              ####################2g(ii)iz(width)10bs(t)(&msg.firstDoor)s0n2bnmz(&msg.variable)(hn)iz
%                          %                 N     =N                               D        AN    ####################(&msg.firstCheckpoint)(hn)izz(1b2a)p(t)(&msg.thisLightbulb)s4n30nmz(t)(&msg.button)sz
%          =         N     %                    B  =           M  Xz                              =####################0n1bm(t)(&msg.throwable)s(width)6bs(1 p on|grab)qz(1a1b2a)p3g3z(t)(&msg.nothingToSee)sz
###########=######################################################################################=####################
###########=######################################################################################=####################
###########=######################################################################################=####################
###########=######################################################################################=####################
###########=######################################################################################=####################
###########=######################################################################################=####################
###########=######################################################################################=####################
###########=###########      N          #  # MI            N                     N                =####################(&msg.firstContinuation)(hn)iz(&msg.firstTrap)(hn)iz2g(ii)iz(&msg.firstChallenge)(hn)iz(&msg.completedFirstChallenge)(hn)iz
###########=###########= Az             Dt D                                                      =####################
###########=###########=                        S             T                                   =####################(name)(throw)sz180r3g3z
###########=###########=###############################################################################################
###########=###########=###############################################################################################
###########=###########=###############################################################################################
###########=###########=###############################################################################################
###########=###########=###############################################################################################
###########=###########=###############################################################################################
###########=###########=###############################################################################################
###########=###########=   N                                                                       ####################(&msg.noMoreHelp)(hn)iz
###########=     D     =                                                                           ####################
###########=           =                                                                           ####################
###########=###########################################################################################################
###########=###########################################################################################################
###########=###########################################################################################################
