##################################+###############
#################################++++++###########
##################################+###+###########
###############################++++++#++##########
###############################+####+#############
##############################++++##P###+######### (bincount)(ps)iz
#################################+##@###+#########
################################++## ###+#########
################################+###:#+++#########
%                               :::::%
%                                    %
%                                    %
%                                    %
$$$$$$$$$$$$$$$$$$$$$$$$$$$$$$$$$$$$!$$$$$$$$$$$
