                       T (name)(yield)sz
                       U 1(yielddrop)gz





              ::::     :::
             ::  :       ::
             :   :  :::::::::::
           :::   ::::   ::  : :
           :::   : ::       :
###########$+$$$$+$$###!###++++++#########
########### :    :     =   D  ##+######### 1(async_door)gz
##########+::=   :     =        :   ######
##########+##=###+#####=#####   :   ######
##########++#=###+#####=########:  =######
###########+#=###+#####=#####++++  =######
###########+#=##+++++##=#####+#### =######
########++++#=##+++#+##=#####+++###=######
########+####=##+#+#+##=###++##+###=######
########+####=######+##=###+++++###=######
########+####=######+##=#+++#######=######
########++## = Az ##+##=##+########=######
########++##     =##+++-+++## M   I= ##### 2g(ii)iz(&msg.slightlyDifferent)(hs)iz
########+######+#=##+##=##+##   Az = #####
########+######+#=##+##=##++# T      ##### (name)(async)sz
########++++###+#=##+##=###+####+#########
####+######++++++-+++##=###+####+#########
####+#++++++#####=##+##=###+####+#########
####+++##########=##+##=###+####+#########
####+#+##########=##+##=###++++++#########
####+#++##   @   =##++#=######+###########
#######+##       =###+#=######+###########
#######+## P      ###+#=######+++++####### 180r(setjmp)(ps)iz
#######+###+#########++-++++##+###+#######
####++++###+###########=###+##+###+#######
#####+#####+###########=###+##+###+#######
#####+++++++++#########=###++++###+#######
#############+#########=##########+#######
#############++++++++++-+++#######+#######
####################+##=##+#######+#######
####################+##=##+#######+#######
###############++++++##=##+++++++++#######
############+++########=##+###############
############+##########=#++###############
############+##########=#+################
############+##########-++################
############+##########=##################
############+##########~##################
############+++++++++##~##################
####################+##~##################
###################++++:+++++#############
###################+###~###+##############
###################+###~#+#+##############
################++++###~###++++++#########
################+######~###+###+##########
################+######~###+###+##########
################+######~++++###+++########
################+######~#+#######+########
###############++++++##~#+#######+########
###############+####+##~#+#######+++######
###############+#+##+##~#+####++++########
############++++####+##~######+##+########
############+##+###NS #~######+##+######## 1(bugrow_door)gz(t)(&msg.waterDamage)s2bn16bnmz
############+##+++#  Az~##+###+##+########
###############+###    ~#####+++##########
###############+#####+#~###+###+##########
##############++++++++#~#####+++##########
##############+######+#~#####+############
#############++######++:++++++############
#############+#########~##+###############
#############+#####+###~##+++#############
#############++++######~####+#############
################+####+#~+###+#############
################+######~####+#############
                :    % ~ %:::
                :    % ~ %:
                :    % ~ %:  :
                :: : % ~ %:
              :::    % ~ %:::
              :  ::: % ~ %  : :
              :::: : % ~ %  :
                :  : % ~:+: :
                   : % ~:%:::
                   ::% ::%   :
                   ::%:: %
                   ::+:  % :
                 :   %   %
                     % : %
                     %   %
               :   : %   %
                 :   %   %
                 :   %   %
                 :   %   %
                 ::: % : %  :
                   : +:: %  ::
                     %   %:
                     %   %
                  :  %   %
                     %   %  :
                     %   %
                 :   %   %
                     %   % :
                     %   %
                     % : %  :
                   : %   %
                     %   %
                  :: %   % :
                   : %   %
                   : % : %
                  :: %  :%
                   : %   % :
                     %:  % :
                     % I % (1 s onCollide|player)v(1+x)e(1-x)e1(yielddrop)gz
                    : ###   :
                   N:(t)(&msg.fellOut)s(width)12bs16nn0nmz

[cSpell: ignore bnmz ]
